            1            1
            2            1
            3            1
            4            1
            5           -3
            6            1
            7           -4
            8           -6
