             1             1
             2             1
             3             1
             4            -1
             5            -2
             6            -3
             7             1
             8            -7
             9             1
            10             1
            11            -9
            12           -10
            13             1
            14             1
            15           -13
            16           -14
            17             1
            18             1
            19             1
            20             1
            21             1
            22             1
            23             1
            24             1
            25           -17
            26           -18
            27           -19
            28           -20
            29           -21
            30           -22
            31           -23
            32           -24
            33             1
            34             1
            35           -33
            36           -34
            37             1
            38             1
            39             1
            40             1
            41           -37
            42           -38
            43           -39
            44           -40
            45             1
            46             1
            47           -45
            48           -46
