             1             1
             2             1
             3            -1
             4            -2
             5             1
             6            -5
             7             1
             8             1
             9             1
            10             1
            11            -8
            12            -7
