             1             1
             2             1
             3             1
             4             1
             5            -1
             6            -4
             7             1
             8            -7
             9             1
            10             1
            11            -3
            12            -2
